16 6
10 5 4 10 27 27 10 27 10 27 9 28 4 27 9 16 
9 1 28 2 27 27 12 27 9 27 9 1 5 4 9 16 
2 14 14 6 21 21 2 27 3 27 3 14 14 20 3 16 
10 8 8 10 29 13 10 17 10 17 10 13 8 8 10 3 
22 7 7 22 24 19 18 23 18 23 18 19 7 7 3 30 
11 11 11 11 11 11 11 11 11 11 11 11 11 11 26 11
512
192