23 6
27 3 7 3 7 3 7 27 12 26 35 27 45 26 35 27 11 41 1 1 8 9 10 
27 3 31 3 31 3 31 27 12 27 7 27 7 27 7 27 14 44 1 43 18 19 20 
27 3 31 3 31 3 31 27 13 27 31 27 31 27 31 27 21 56 52 42 28 29 30 
27 3 6 36 37 38 6 27 3 27 31 27 31 27 15 17 15 24 57 58 1 39 40 
17 15 15 46 47 48 15 17 15 17 16 17 16 17 5 22 23 34 24 1 1 49 50 
4 4 4 4 4 4 4 4 51 51 51 51 51 51 51 32 33 21 25 2 2 59 60
320
192