48 6
36 60 8 72 69 1 1 1 1 1 1 1 1 1 1 1 1 1 1 1 1 1 1 1 1 1 1 1 1 1 1 1 1 1 1 1 1 1 1 1 1 1 1 3 2 2 14 8 
36 63 18 72 1 1 1 1 1 1 1 1 1 1 1 1 1 1 1 1 1 3 31 31 2 27 1 1 1 1 1 1 1 1 1 1 1 1 1 1 1 1 1 10 5 5 4 18 
36 64 13 67 24 24 24 24 24 24 70 24 70 24 70 24 24 24 70 24 70 71 13 13 76 37 24 70 24 24 70 24 24 70 24 70 24 70 24 24 24 24 24 20 6 6 9 4 
36 68 68 68 68 68 22 26 26 26 26 21 21 21 26 26 26 21 26 26 26 32 32 32 32 32 21 26 26 21 26 26 26 21 26 26 26 26 26 26 21 53 75 15 78 6 19 4 
36 4 55 74 48 4 56 7 7 33 41 42 65 25 7 7 7 25 7 33 34 40 35 39 39 28 25 7 7 25 7 7 7 25 7 7 7 7 7 7 25 47 11 13 77 11 29 13 
66 45 61 62 58 45 61 17 17 43 51 52 44 17 17 17 17 17 17 43 44 50 45 49 49 38 17 17 17 17 17 17 17 17 17 17 17 17 17 17 17 62 30 30 30 30 30 30
320
256