24 6
6 88 53 86 85 11 84 78 71 36 34 35 30 61 33 58 49 53 48 53 48 53 38 1 
7 88 53 92 54 1 82 34 81 46 44 45 40 33 9 4 39 4 4 4 4 14 48 1 
8 24 14 91 53 1 71 37 51 50 29 31 32 33 60 1 49 54 54 55 54 15 2 1 
1 88 23 19 87 1 80 47 4 4 70 41 42 43 62 1 49 56 56 57 17 16 52 1 
1 88 53 15 13 1 83 76 69 60 15 72 31 74 63 1 59 4 4 3 18 17 2 1 
5 89 90 20 5 5 79 77 75 68 67 66 73 65 64 5 5 5 5 5 21 20 21 5
320 
320