24  6
1 13 25 27 14 1 49 40 76 66 38 31 52 53 70 1 51 8 64 71 28 27 14 10 
1 79 26 7 57 3 59 50 12 21 22 23 37 41 51 1 51 18 25 72 27 64 67 20 
1 13 15 9 56 58 60 42 51 31 32 33 47 42 51 1 51 25 27 16 64 64 65 30 
1 13 64 19 67 56 57 42 51 23 55 36 35 43 62 1 62 69 68 68 65 64 51 1 
1 13 14 29 64 61 56 43 62 24 34 46 73 44 2 1 1 1 1 1 51 64 51 1 
3 78 77 5 5 6 77 3 3 45 74 75 74 45 4 3 3 3 3 3 4 5 4 3
320
320