88 6
56 4 2 70 1 4 2 70 1 4 78 70 1 4 2 70 26 4 2 47 1 1 1 1 4 49 74 4 50 1 1 26 4 47 4 47 4 47 4 1 47 1 1 50 50 74 4 52 11 12 13 14 13 57 57 57 16 12 16 13 13 57 57 131 1 56 4 50 1 4 47 1 4 109 111 20 91 21 4 22 91 21 4 22 91 78 47 43 
50 4 25 47 1 4 71 47 1 4 2 47 1 4 25 47 50 4 71 74 1 1 1 27 24 48 8 9 10 1 1 50 4 74 4 74 4 74 4 70 74 1 1 27 98 3 24 53 34 35 13 37 13 13 128 128 16 106 14 13 12 13 13 53 1 17 19 110 1 4 74 1 4 132 50 1 4 44 4 45 4 44 4 67 4 49 74 66 
1 4 48 74 1 4 25 74 70 4 71 74 1 4 48 74 1 4 71 74 1 27 72 28 5 93 95 5 32 31 77 98 4 74 4 74 4 74 4 26 74 1 6 28 93 93 5 54 15 58 58 36 13 130 81 80 61 62 39 13 104 115 114 23 40 64 18 32 31 19 94 42 19 110 1 1 4 1 4 1 4 1 4 26 4 48 113 89 
1 4 1 74 70 4 48 74 26 4 25 74 1 4 1 74 56 4 25 94 72 28 33 96 4 1 50 4 97 5 33 33 4 74 4 74 4 74 4 99 74 6 100 29 1 1 4 55 38 81 81 14 58 59 105 81 60 60 129 58 59 105 35 108 63 1 4 97 33 5 95 5 95 32 31 1 4 1 4 1 4 1 4 50 4 7 28 69 
1 24 77 3 75 24 77 3 73 24 79 3 77 24 77 3 73 24 79 72 51 30 75 77 24 77 77 24 77 24 75 75 24 3 24 3 24 3 24 75 7 51 30 75 1 1 24 55 38 130 13 37 81 127 103 82 60 60 37 83 127 103 82 108 86 1 24 77 75 24 50 24 50 65 88 31 24 77 24 77 24 77 24 77 24 90 30 92 
76 76 76 76 76 76 76 76 76 76 76 76 76 76 76 76 76 76 76 76 76 76 76 76 76 76 76 76 76 76 76 76 76 76 76 76 76 76 76 76 76 76 76 76 76 76 76 76 76 107 76 76 76 76 76 76 85 85 76 107 76 76 76 76 76 76 76 76 76 76 76 76 76 76 76 76 76 76 76 76 76 76 76 76 76 76 76 76
736
192