24 6 
1 9 9 9 9 9 3 3 1 9 9 9 9 9 3 3 3 3 3 3 5 6 7 8 
17 19 17 17 17 17 9 9 17 19 17 17 17 17 9 9 9 9 12 12 13 14 15 16 
19 2 19 19 19 19 19 19 19 2 19 19 19 19 19 19 19 19 2 2 21 22 23 24 
25 10 2 25 25 2 25 2 25 10 2 25 25 2 25 2 2 2 10 4 29 30 31 32 
27 26 18 27 27 18 27 18 27 26 18 27 27 18 27 18 18 20 26 11 37 38 39 40 
4 4 4 4 4 4 4 4 4 4 4 4 4 4 4 4 4 4 4 4 4 4 4 4
256		
160 	