49 6
30 4 2 31 1 4 2 31 1 4 39 31 1 4 2 31 13 4 2 21 1 1 1 1 4 23 35 4 24 1 1 13 4 21 4 21 4 21 4 1 21 1 1 24 24 35 4 26 51 
34 4 12 21 1 4 32 21 1 4 2 21 1 4 12 21 24 4 32 35 1 1 1 14 11 22 8 9 10 1 1 24 4 35 4 35 4 35 4 31 35 1 1 14 46 3 11 27 52 
1 4 22 35 1 4 12 35 31 4 32 35 1 4 22 35 1 4 32 35 1 14 33 15 5 41 43 5 19 18 38 46 4 35 4 35 4 35 4 13 35 1 6 15 41 41 5 28 49 
1 4 1 35 31 4 22 35 13 4 12 35 1 4 1 35 30 4 12 42 33 15 20 44 4 1 24 4 45 5 20 20 4 35 4 35 4 35 4 47 35 6 48 16 1 1 4 29 50 
1 11 38 3 36 11 38 3 34 11 40 3 38 11 38 3 34 11 40 33 25 17 36 38 11 38 38 11 38 11 36 36 11 3 11 3 11 3 11 36 7 25 17 36 1 1 11 29 50 
37 37 37 37 37 37 37 37 37 37 37 37 37 37 37 37 37 37 37 37 37 37 37 37 37 37 37 37 37 37 37 37 37 37 37 37 37 37 37 37 37 37 37 37 37 37 37 37 37
320
192