9 6
32 10 10 9 33 1 1 2 3 
18 15 10 8 9 33 1 2 3 
1 13 12 14 11 34 6 4 5 
1 1 19 20 17 11 10 10 7 
1 1 1 1 18 21 11 10 7 
22 23 29 30 31 24 25 26 27
224
160